                
      #           
 ## # ######    
    # #######   
  ###           
    #######     
 ###            
    # ######    
 ####     ##    
 #### ######    
          ##    
  ########## #  
           # #  
    ##       #  
                
