######
#    #
## # #
#  # #
# ## #
#### #